1111111111111
1E00000000001
1111111111101
1MC0001MC0101
1000101000101
1101101110101
1M0C100000101
1000101111101
1101100000001
1101110111111
100C100010001
100C10P01C0M1
1111111111111